##########
#P       #
#        #
#        #
#     M  #
#        #
#        #
#        #
# G      #
##########